###########
#S..#....G#
#.#.#.#.#.#
#.#...#.#.#
#.#.###.#.#
#...#.....#
###########
